111000000000000000000000000000000000
111006000000000000000000000000000060
111000000000000000000000000000000000
000000000000000000000000000000000000
000000000000000000000000000000000000
000000000000000000000000111000000000
000000000001111106000000111000000000
000000000001111100060000111000000000
000000000000000000000000000000000000
000000000000000000000000000000000000
000000000000000000000000000000000000
000000000060000000000000000000000000
000000000000000000000000000000000000
110000000000000001111000000000000000
110000000000000001111000000000000000
110000000000000001111000000000000000
110000000000000000000000000000000000
000000000000000000000000000000000000
