111000000000000000000000000000000000
111000060000000000000000000000000600
111000000000000000000000000000000000
000000000000000000000000000000000000
000000000000000000000000000000000000
000000000000000000000000111000000000
000000000001111100060000111000000000
000000000001111106000000111000000000
000000000000000000000000000000000000
000000000000000000000000060000000000
000000000000000000000000000000000000
000060000000060000000000000000000000
000000000000000000000000000000000000
110000000000600001111000000000000000
110000000000000001111000000000060000
110000000000000001111000000000000000
110000000000000000000000000000600000
000000000000000000000000000000000000
