111000000000000000000000000000000000
111000000000000600000000000000000000
111000000000000000000000000000000000
000000000000000000000000000000000000
000000000000000000000000000000000000
000000000000000000000000111000000000
000600000001111100060000111000000000
000000000001111100000000111000000000
000000000000000000000000000000000000
000000000000000000000000000000000000
000000000000000000000000000000000000
000000000006000000000000000000000000
000000000000000000000000000000000000
110600000006000001111000000000000000
110000000600000001111000000000000000
110000000000000001111000060000000000
110000000000000000000000000000600000
000000000000000000000000000000000000
