111000000000000000000000000000000000
111000000000000600000000000000000060
111000000000000000000000000000000000
000000000000000000000000000000000000
000000000000000000000000000000000000
000000000000000000000000111000000000
000000000001111100006000111000000000
000000000001111100000000111000000000
000000000000000000000000000000000000
000000000000000000000000000000000000
000000000000000000000000000000000000
000000000600000000000000000000000000
000000000000000000000000000000000000
110600000006000001111000000000000000
110000000000000001111000000000000000
110000000000000001111000000000000000
110000000000000000000000000000000000
000000000000000000000000000000000000
