111000000000000000000000000000000000
111060000000000000000000000000000000
111000000000000000000000000000000000
000000000000000000000000000000000000
000000000000000000000000000000000000
000000000000000000000000111000000000
006000000001111100000000111000000000
000000000001111100006000111000000000
000000000000000000000000000000000000
000000000000000000000000000000000000
000000000000000000000000000000000000
000000000000000000000000000000000000
000000000000000000000000000000000000
110000000000600001111000000000000000
110000000000000001111000000060000000
110000000000000001111000000000000000
110000000000000000000000000000000000
000000000000000000000000000000000000
