111000000000000000000000000000000000
111000000000000000000000000000000000
111000000000000000000000000000000000
000000000000000000000000000000000000
000000000000000000000000000000000000
000000000000000000000000111000000000
060000000001111100000000111000000000
000000000001111100006000111000000000
000000000000000000000000000000000000
000000000000000000000000000000000000
000000000000000000000000000000000000
060060006000000000000000000000000000
000000000000000000000000000000000000
110000000060060001111000000000000000
110000000000000001111000000000000000
110000000000000001111000060000000000
110000000000000000000000000000060000
000000000000000000000000000000000000
