111000000000000000000000000000000000
111000000000000000000000000000000000
111000000000000000000000000000000000
000000000000000000000000000000000000
000000000000000000000000000000000000
000000000000000000000000111000000000
000000000001111106060000111000000000
000000000001111100000000111000000000
000000000000000000000000000000000000
000000000000000000000000000000000000
000000000000000000000000000000000000
000000000000000000000000000000000000
000000000600000000000000000000000000
110000000000000001111000000000000000
110000000000000001111000000000060000
110000000000000001111000000000000000
110000000000000000000000000000000000
000000000000000000000000000000000000
