111000000000000000000000000000000000
111000000000060000000000000000006000
111000000000000000000000000000000060
000000000000000000000000000000000000
000000000000000000000000000000000000
000000000000000000000000111000000000
000000000001111100006000111000000000
000000000001111100000000111000000000
000000000000000000000000000000000000
000000000000000000000000060000000000
000000000000000000000000000000000000
000600006006000000000000000000000000
000000000000000000000000000000000000
110000000000000001111000000000000000
110000000000000001111000000000000000
110000000000000001111000000000000000
110000000000000000000000000000060000
000000000000000000000000000000000000
