111000000000000000000000000000000000
111060060000006000000000000000000000
111000000000000000000000000000000000
000000000000000000000000000000000000
000000000000000000000000000000000000
000000000000000000000000111000000000
000000000001111100000000111000000000
000600000001111100000000111000000000
000000000000000000000000000000000000
000000000000000000000000000000000000
000000000000000000000000000000000000
000060000060000000000000000000000000
000000000000000000000000000000000000
110600000000600001111000000000000000
110000000000000001111000000000600000
110000000000000001111000000000000000
110000000000000000000000000000000000
000000000000000000000000000000000000
