111000000000000000000000000000000000
111044440004444400000000000000004440
111000000000000000000000000000000040
000000000000000000000000000000000000
000000000000000000000000000000000000
000000000000000000000000111000000000
044400000001111104444000111000000000
044400000001111104444000111000000000
000000000000000000000000000000000000
000000000000000000000000044000000000
000000000000000000000000000000000000
044440004444440000000000000000000000
000440000444440000000000000000000000
110440000444440001111000000000000000
110000000440000001111000000444440000
110000000000000001111000440000440000
110000000000000000000000000000440000
000000000000000000000000000000000000