111000000000000000000000000000000000
111000060000000000000000000000000060
111000000000000000000000000000000000
111000000000000000000000000000000060
000000000000000000000000000000000000
000000000000000000000000000000000000
000000000000000000000000111000000000
000600000001111100000000111000000000
000000000001111100600000111000000000
000000000000000000000000000000000000
000000000000000000000000000000000000
000000000000000000000000000000000000
000000000000000000000000000000000000
000000000000000000000000000000000000
110000000000000001111000000000000000
110000000000000001111000000000000000
110000000000000001111000000000000000
110000000000000000000000000000000000
000000000000000000000000000000000000
