111000000000000000000000000000000000
111000600000000000000000000000006000
111000000000000000000000000000000000
000000000000000000000000000000000000
000000000000000000000000000000000000
000000000000000000000000111000000000
000000000001111100000000111000000000
000000000001111100000000111000000000
000000000000000000000000000000000000
000000000000000000000000000000000000
000000000000000000000000000000000000
060600000000060000000000000000000000
000000000000000000000000000000000000
110600000006000001111000000000000000
110000000600000001111000000060000000
110000000000000001111000000000000000
110000000000000000000000000000000000
000000000000000000000000000000000000
